district,observation,isolation,total_hospitalized,hospitalized_today,active,recovered,deceased,total_cases,cases_delta
Thiruvananthapuram,28,25,3,8,0,0,0,0,0
Kollam,9,8,1,0,0,0,0,0,0
Pathanamthitta,3,2,1,0,0,0,0,0,0
Idukki,5,5,0,3,0,0,0,0,0
Kottayam,35,35,0,2,0,0,0,0,0
Alappuzha,9,9,0,1,0,1,0,1,0
Ernakulam,80,78,2,0,0,0,0,0,0
Thrissur,52,46,6,4,0,1,0,1,0
Palakkad,9,8,1,0,0,0,0,0,0
Malappuram,6,6,0,2,0,0,0,0,0
Kozhikode,9,7,2,0,0,0,0,0,0
Wayanad,4,4,0,0,0,0,0,0,0
Kannur,22,22,0,0,0,0,0,0,0
Kasaragod,22,21,1,0,0,1,0,1,0
Total,293,276,17,20,0,3,0,3,0
